-500      A  
500    S  
1500   D  
2000   F  
3000   A  
3500   S  
4500   D  
5000   F  
6000   A  
6500   S  
7500   D  
8000   F  
9000   A  
9500   S  
10500  D  
11000  F  
12000  A  
12500  S  
13500  D  
14000  F  
15000  A  
15500  S  
16500  D  
17000  F  
18000  A  
18500  S  
19500  D  
20000  F  
21000  A  
21500  S  
22500  D  
23000  F  
24000  A  
24500  S  
25500  D  
26000  F  
27000  A  
27500  S  
28500  D  
29000  F  
30000  A  
30500  S  
31500  D  
32000  F  
