0      A  
924    S  
1848   D  
2772   F  
3696   A  
4620   S  
5544   D  
6468   F  
8316   A  
9240   S  
10164  D  
11088  F  
13860  A  
14784  S  
15708  D  
16632  F  
18480  A  
19404  S  
20328  D  
21252  F  
23100  A  
24024  S  
24948  D  
25872  F  
27720  A  
28644  S  
29568  D  
30492  F  
32340  A  
33264  S  
34188  D  
