0      A  
924    S  
1848   D  
2772   F  
3696   A  
4620   S  
5544   D  
7392   A
8316   S  
9240   D  
10164  F  
11088  A
12936  D
13860  F  
14784  A  
15708  S  
16632  D 
17556  F 
18480  A  
19404  S  
20328  D
22176  A
23100  S  
24024  D  
24948  F  
25872  A 
27720  D  
28644  F  
29568  A  
30492  S
31434  D  
32340  F  
